#################################################
#...............................................#
#...............................................#
#...........##################..................#
#...............................................#
#...............................................#
#...............................................#
#...............................................#
#...............................................#
#...............................................#
#...............................................#
#...............................................#
#################################################